41121112114
5    3    5
1         1
2  2   2  5
1         1
5    3    5
1    5    1
5         5
2  2   2  1
41121112114